0 5 5 5 13 5 5 5 8 5 13 8 5 5 5 5 5 5 5 5 8 13 5 5 5 5 5 13 5 5 5 1 
7 9 9 9 9 9 9 9 7 16 11 7 9 9 9 9 9 9 9 9 7 9 9 9 9 9 9 9 9 9 9 7 
7 10 10 10 10 10 10 10 7 17 15 2 5 5 13 5 5 13 5 5 3 10 10 10 10 10 10 10 10 10 10 7 
7 10 10 10 10 10 10 15 26 10 10 9 9 9 9 9 9 9 9 9 9 10 10 10 10 10 10 10 10 10 10 7 
7 10 10 11 10 10 10 10 10 10 10 10 10 10 10 10 16 10 10 10 10 10 10 10 10 10 10 10 10 10 10 7 
7 10 10 10 10 10 11 10 19 10 10 10 10 10 10 15 17 10 10 10 10 10 10 10 10 10 10 10 10 10 10 7 
7 10 10 10 10 10 10 10 7 10 10 10 10 10 10 10 10 10 10 10 10 10 10 10 10 10 10 10 10 10 11 7 
7 10 11 10 10 10 10 10 7 10 10 10 10 10 10 10 10 10 10 10 10 10 10 10 16 10 10 10 10 10 10 7 
7 10 10 10 10 10 10 10 7 10 10 10 10 10 10 10 11 10 10 10 10 10 10 10 17 15 15 10 10 10 10 7 
7 10 10 16 10 10 10 10 7 10 10 10 10 10 10 10 10 10 10 10 10 10 10 10 10 10 10 10 10 10 11 7 
7 10 10 17 15 15 10 10 7 10 10 10 10 10 10 10 10 10 10 10 10 11 10 10 10 10 10 10 10 10 10 7 
28 13 5 5 5 5 5 5 14 10 11 10 10 10 10 10 10 10 10 10 10 10 10 10 10 10 10 10 10 10 10 7 
7 9 9 9 9 9 9 9 9 10 10 10 10 16 10 10 10 10 10 10 10 10 10 10 10 10 10 10 10 10 10 7 
7 10 10 10 10 10 10 15 10 10 10 10 10 17 15 10 10 10 10 10 10 10 11 10 10 10 10 10 10 10 10 7 
7 10 10 10 10 10 16 10 10 10 10 10 10 10 10 10 10 10 10 10 10 10 10 10 10 10 10 10 10 10 10 7 
7 10 10 10 10 10 17 15 10 10 10 10 10 10 10 10 10 10 10 10 10 10 10 11 10 10 15 15 10 10 10 7 
7 10 10 10 10 10 10 15 15 15 10 10 10 10 10 10 10 10 10 10 10 10 10 10 10 10 10 10 10 10 10 7 
2 5 5 5 5 5 5 5 5 5 5 5 5 5 5 5 5 5 5 5 5 5 5 5 5 5 5 5 5 5 5 3 